"a" = (/turf/simulated/floor/plating/planet/ullr,/area/space)
"b" = (/obj/machinery/meter/turf,/turf/simulated/floor/plating/planet/ullr,/area/space)
"c" = (/obj/item/device/analyzer,/turf/simulated/floor/plating/planet/ullr,/area/space)
"d" = (/obj/item/drone_shell,/turf/simulated/floor/plating/planet/ullr,/area/space)
"e" = (/turf/simulated/wall,/area/start)
"f" = (/obj/machinery/door/airlock,/turf/simulated/floor/plasteel/floorgrime,/area/start)
"g" = (/obj/structure/grille,/obj/structure/window/fulltile,/turf/simulated/floor/plating,/area/start)
"h" = (/obj/machinery/meter/turf,/turf/simulated/floor/plasteel/floorgrime,/area/start)
"i" = (/turf/simulated/floor/plasteel/floorgrime,/area/start)
"j" = (/obj/item/weapon/grenade/clusterbuster/inferno,/turf/simulated/floor/plasteel/floorgrime,/area/start)
"k" = (/obj/item/device/analyzer,/turf/simulated/floor/plasteel/floorgrime,/area/start)
"l" = (/obj/effect/landmark/start,/turf/simulated/floor/plasteel/floorgrime,/area/start)
"m" = (/obj/effect/landmark/latejoin,/obj/item/drone_shell,/turf/simulated/floor/plasteel/floorgrime,/area/start)
"n" = (/turf/simulated/wall,/area/space)
"o" = (/obj/machinery/meter/turf,/turf/simulated/floor/plasteel/floorgrime,/area/space)

(1,1,1) = {"
aaaaaaaaaaaaaaaaaaaaaaaaaaaaaaaa
aaaaaaaaaaaaaaaaaaaaaaaaaaaaaaaa
aaaaaaaaaaaaaaaaaaaaaaaaaaaaaaaa
aaaaaaaaaaaaaaaaaaaaaaaaaaaaaaaa
aaaaaaaaaaaaaaaaaaaaaaaaaaaaaaaa
aaaaaaaaaaaaaaaaaaaaaaaaaaaaaaaa
aaaaaaaaaaaaaaaaaaaaaaaaaaaaaaaa
aaaaaaaaaaaaaaaaaaaaaaaaaaaaaaaa
aaaaaaaaaaaaaaaaaaaaaaaaaaaaaaaa
aaaaaaaaaaaaaaaaaaaaaaaaaaaaaaaa
aaaaaaaaaaaaaaaaaaaaaaaaaaaaaaaa
aaaaaaaaaaaaaaabaaaaaaaaaaaaaaaa
aaaaaaaaaaacaaadaaacaaaaaaaaaaaa
aaaaaaaaaaaaeeefeeeaaaaaaaaaaaaa
aaaaaaaaaaaaghijihgaaaaaaaaaaaaa
aaaaaaaaaaaagiklkigaaaaaaaaaaaaa
aaaaaaaaaabdgjlmljgdbaaaaaaaaaaa
aaaaaaaaaaaagiklkigaaaaaaaaaaaaa
aaaaaaaaaaaaghijihgaaaaaaaaaaaaa
aaaaaaaaaaaagggggggaaaaaaaaaaaaa
aaaaaaaaaaacaaadaaacaaaaaaaaaaaa
aaaaaaaaaaaaaaabaaaaaaaaaaaaaaaa
aaaaaaaaaaaaaaaaaaaaaaaaaaaaaaaa
aaaaaaaaaaaaaaaaaaaaaaaaaaaaaaaa
aaaaaaaaaaaaaaaaaaaaaaaaaaaaaaaa
aaaaaaaaaaaaaaaaaaaaaaaaaaaaaaaa
aaaaaaaaaaaaaaaaaaaaaaaaaaaaaaaa
aaaaaaaaaaaannnnaaaaaaaaaaaaaaaa
aaaaaaaaaaaanobnaaaaaaaaaaaaaaaa
aaaaaaaaaaaannnnaaaaaaaaaaaaaaaa
aaaaaaaaaaaaaaaaaaaaaaaaaaaaaaaa
aaaaaaaaaaaaaaaaaaaaaaaaaaaaaaaa
"}
